111111111111111
1P0000000000CE1
111111111111111