111111111111111
1C00000001000E1
1C0000000000C01
1P0000C10000001
111111111111111