11111111111111111111111111
1P00000000010000C000000001
100000C000C0001
10000001C0001
1C000000000010000000000001
100000000C0000000000000001
10C000010000C00C000001
1C000C00010000E1
100000000111111