111111111111111
1P000000000ECC1
111111111111111