11111111111111111111111111
1P000000000100000000000001
10000100000000000C00000001
10000001000000000000100001
1000000000001000000000X001
10000100000000000000000001
10000001000100000000000001
100100000000000000010000E1
11111111111111111111111111