1111111111
1P0C0000E1
100C100PE1
1111111111