1111111111111111
1C00000001000E11
10C0000000000C01
1P0000C100000011
1111111111111111

