11111111111111111111111111
0P00000000010000C000000001
100000C000C000000000000001
000000010000000000001C0000
1C000000000010000000000001
100000000C0000000000000001
1C0000C000010000C00C000000
100000C0000C000C00010000E1
11111111111111111111111111