11111111111111111111111111
11111111111111111111111111
1P00000000010000C000000001
100000C000C000000000000001
10000001C00000000000000001
1C000000000010000000000001
100000000C0000000000000001
10C000010000C00C0000000001
1C000C00010000000000000E11
11111111111111111111111111